0s0s0s0s0s0s
0s0s0s0s0s0s
0s0sws0s0s0s
0s0s0s^i<i0s
0s0s0s0sas0s
0s0s0s0s0s0s