0s0s0s0s0s0s
0s0s0s0s0s0s
0s0s0s0s0s0s
0s0s>i0s0s0s
0s0sas0sws0s
0s0s0s0s0s0s