0s0s0s0s0s0s
0s0svi0s0s0s
0srsai0s0s0s
0s0s0s0s0s0s
0sws0s0s0s0s
0s0s0s0s0s0s