0srsvi0s0s0s
0s0s>ivi0s0s
0s0sai0s0s0s
0s0s0s0s0s0s
0s0sws0s0s0s
0s0s0s0s0s0s